11111111111111111111111111
100100000C0001000C00C000C1
10010002020001020C01002201
101111100000C0000001111001
1000000C0200020001C0022001
1020002000010000C000110001
111111000C10002020C00020C1
1002111100000220000000C001
1C000010020PE000C000022001
11100220011000C20111000C01
10000C0021111C020002001111
10020011111C1011002000C001
10000C0000100C110000002021
11111111111111111111111111
