111111111
10P000001
1002001C1
10EC00121
111111111
