111111111
1000E0001
1C0C0C0C1
1000P0001
1C0C0C0C1
100000001
111111111
