1111111111111111111
100000000000000001
1000100000000000001
1000001111111110001
100P00000011E000011
1111111111111111111
