1111111111111111111
1C0000000000C0C0001
1000102000000000201
1000001111111110001
100P02200011E000011
110000C00C1100200C1
10200110000C0000201
1111111111111111111
