1111111111111111111
100000000000C0C0001
1000100000000000001
1000001111111110001
100P00000011E000011
110000C00C1100000C1
10000110000C0000001
1111111111111111111
